XXXXX.XXXX
X...XXX..X
X....J...X
XX.XXXX..X
.XJXGGXJXX
.X.XGGGGGX
.X...GGX.XXX
.X.XJXX.J..X
.X..JMJJ...X
XX.XXJX..XXX
X.......XX
X...XXXXX
XXXXX
