.XXXXX
.X...XXX.
.X..J..X.
XXXGJG.X.
X..JGJXXX
X.XGJG..X
X.XJMJX.X
X..GJGX.X
XXXJGJ..X
.X.GJGXXX
.X..G..X.
.XXX...X.
...XXXXX.
