XXXXXXXXXXXXXXXXXXX
X..G...G.X........X
XGXJXXJX.X.XJXXJX.X
XJ..XX.J..J.GXXG.GX
XGXJ..GX.X.X..J.X.X
X...XX...X..GXXG.GX
X.XJXXJXXXXX.XX.X.X
X.....G..XMJ..G.J.X
X.....G..X.J..G.J.X
X.XJXXJXXXXX.XX.X.X
X...XX...X..GXXG.GX
XGXJ..GX.X.X..J.X.X
XJ..XX.J..J.GXXGXGX
XGXJXXJX.X.XJXXJX.X
X..G...G.X........X
XXXXXXXXXXXXXXXXXXX
