XXXXX
X...XXXXX
X.X.XX..X
X.J....JXX
XXX.GGX..X
..XJGGG..X
XXX.MGGX.X
X.J..J.J.X
X.X.XXXJ.X
X...X.X..X
XXXXX.XXXX
