...XXXX
.XXX..X
XX....XXX
X.J.J...X
X.XJX.XJXX
X.G.GJG..X
XXGMG.XJ.X
.XXXG...XX
...X..XXX
...XXXX
