..XXXXXXX
..X..X..XXX
XXXGJGJG.MX
X..G.XJGJ.X
X.XJ.GJG.XX
X..G.JJ.XX
XXX..X..X
..XXXXXXX
