..XXXXXX.
XXX.MG.X.
X.G.JX.XX
X.J.G.J.X
XX.X.JG.X
.X.GJ.XXX
.XX..XX..
..XXXX...
