XXXXXXXXXXXXX
XXXX..G..XXXX
XX.J.XGX.J..X
X.J.JXGXJ.J.X
X..JGG.GGJ..X
XXX.XXMXX.XXX
XXX...G...XXX
XXXXXXXXXXXXX
