....XXXXX
...XX...XXX
..XX......X
.XX.JXJJX.XX
XX.J..J..J.X
X..X.XJX.X.X
X..GGGMGGGGX
X..XXXXXXXXX
XXXX
