.XXXXX
.X...XXXX
.X.GMG..X
XXXGJX..X
X.JGJGJXX
X..GXG.XX
XXJ.J.J.X
.X..X...X.
.XXXXXXXX
