XXXXXXXXXXXXXXX
XXXXX...XXX...X
XXXMJ.X..J....X
XXXJXGXXXXXXJXX
XXX.GGGGX..X.XX
X...G.G.X..X.XX
X.X.GGGGX..X.XX
X.X....XXXXX.XX
X.J.XXJX...X.XX
XXXJJ..XJ..X.XX
XXX...........X
XXXX..X..JX.J.X
XXXXXXXX..XX..X
XXXXXXXXXXXXXXX
