XXXXXXX
XGGG..XXX
X.XX....X
X..J..J.X
XGXJXXJXX
X...XM.X
XXX...XX.
..XXXXX
