......XXXXX
XXXX.XX...XXX
X..XXX..XJM.X
XGGG.....JJ.X
XG.GXX.X.X..X
XGGGX..JJXJXX
XX..JJX.....X
.XXX....X...X
...XXX..XXXXX
.....XXXX
