..XXXXXXX..
..X..X..X..
..X.....X..
..XGGXJJX..
XXX.....XXX
X.GGGXJJJ.X
X.........X
XXXGGXJJXXX
..X..M..X..
..XXXXXXX..
