XXXXXXXXX
X...X...X
X.J.M.J.X
XX.XXX.XX
X..GXG..X
X.JGGGJ.X
XXJGXGJXX
X..XXX..X
X...J...X
X..XXX..X
XXXXXXXXX
