..XXXXX..
.XX...XX.
XX..X..XX
XX.GJG.XX
X.JJGJJ.X
X.GJJJG.X
XX.G+G.XX
.XXXXXXX.
