....XXXX
XXXXXM.X
X.J.JJJXX
X..GXG..X
XX.X..X.X
.X.G.G..X
.X...XXXX
.XXXXX
