XXXXX..XXXX
X...XXXX..X
X......J.MX
XXJXXXXX..X
X..XGGGJ.XX
X..JG.GX..X
X..XGGGXXJXX
XXJXXXJXX..X
X.......J..X
X...XX..X..X
XXXXXXXXXXXX
