XXXXXX
X...GXXXXX
X.X.G....X
X.X.GXJX.X
XG..GX.J.X
XX.XGM.X.X
.X.J.X.J.X
.XXX..JJ.X
...XX...XX
....XXXXXX
