...XXXXX
XXXX...X
X..XGXJXXX
X...G.J..X
XGGGGXJX.X
XXXJX.J..X
.X.J..M.XX
.X...XXXX
.XXXXX
