...XXXXX
..XX...XXXX
.XX.JGJ...X
.X..XGX...X
XX.G.M.XJXX
X..XGX.GJ.X
X...G.X...X
XXX.J.J.XXX
..XXXX..X
.....XXXX
