...XXXXX
XXXX...X
X....J.X
X...XJXXX
XX.XX.M.X
X.GGX...X
X.GGJJ.XX
XX..X..X
.XXXXXXX
