.XXXX
XXM.XXXXX
X.JJJ...X
X.X.X.X.X
X.GGG...X
XXXX...XX
...XXXXX
