....XXXX
XXXXX..X
X...XJ.X
X......XX
XXJXXX..X
.X..GGG.X
XXJX.GXXX
X..XXMXX
X..J...X
X..X...X
XXXXXXXX
