..XXXXXXX
XXX..X..XXX
X..JGMGJ..X
X.X.GGG.X.X
X.J.XGX.J.X
XX..XGX..XX
.X.J.J.J.X
.X..XXX..X
.XXXX.XXXX
