............XXXX
.XXXXXXXXXXXX..XXXXX
.X....X..X.....X...XX
.X.J.J.J..JJX.J.J...X
.XXJ.J...X.MX.J...J.X
XXX...XXXXXXXXXXXX.XX
X..J.JX.GGGGGXGGGXJX
X.X...X.G..GXXGGXX.X
X.XXX.XXGX.GGXG.X..X
X.X...JGGX.GGXGGJJ.X
X.X.J.X..X.XGG.GX..X
X..J.JXGGGGGGGGGX.JX
X.J...XGGXXJXXXXX..X
X.J.J.XXXX.J.J..J.JX
XX.X.....J.J.J.J...XXX
.X.XXXXXXX.J....J....X
.X.........X.XXXXXXX.X
.XXXXXXX.XJ..........X
.......X...XXXXXXXXXXX
.......XXXXX
