XXXXX
X...XXXXXXX
X.J....X..X
XXJX...JJ.X
X..XXGXX..X
X.JJGGG..XX
X..XGGGXMX
X.XXXX.XJX
X........X
XXXXXXXXXX
