XXXXXXX..
XGGG..XXX
XMXXJJ..X
X.J.....X
XGX.XX.XX
X.J.X..X
XXX...XX
..XXXXX
