XXXXX.XXXX
X...XXX..XX
X....J....X
XXJXXMX.XJX
.X.XGGGG..X
XX..GGGGX.X
X.JX.X.XXJXX
X..J.J.J...X
X..XXXXX...X
XXXX...XXXXX
