XXXXXXXXXXXX
XX...X....MX
XX....J.JJ.X
XXGG.XXJ..XX
X.GG.X..XXXX
X.......XXXX
XXXXXXXXXXXX
