XXXXX
X...X
XJM.X
XG..X
XXXXX
