XXXXXXXX
XXXXX..X
XXX.JJ.X
XXX.X..X
XX.GXJMX
X......X
X.GGXXXX
XXXXXXXX
