XXXXXX
X..XXX
X..XXX
X..XXX
XGJJMX
X..G.X
X..XXX
XXXXXX
