XXXXXXX
XX...XX
XXJXM.X
XX.J..X
XX..XXX
X.JG..X
XG.G..X
XXXXXXX
