XXXXXX
XGX..X
XMJJ.X
XGGJ.X
XX...X
XXXXXX
