XXXXXXX
XX..XXX
X.GJ..X
XMGJ..X
X.GJ.XX
XX..XXX
XXXXXXX
