XXXXXXX
X...XXX
X...XXX
XJJJM.X
XGGG..X
XXXXXXX
