XXXXXXX
X.....X
X.JJJGX
XX.XMGX
XX.X.GX
XX..X.X
XXX...X
XXXXXXX
