XXXXXXXXXXXX
XXXXXX...XXX
X...XX.X.XXX
X.JMJ....XXX
XXX.XXX.XXXX
X.........XX
X...XXX.GG.X
XXXXX....X.X
XXXXX.X..X.X
XXXXX..XX..X
XXXXXX....XX
XXXXXXXXXXXX
