XXXXXXXXXXXX
XX...XXX...X
XXMJ..XXGG.X
XXXJX......X
X...XX.XX..X
X.......XXXX
X...X...XXXX
XXXXXXXXXXXX
