XXXXXXX
XX...XX
X.GJG.X
X.JXJ.X
X.GJG.X
X....XX
XX.MXXX
XXXXXXX
