XXXXXXXXX
XXXXX..XX
XXG.G..XX
XX..X.M.X
XXX.X...X
XXX.XX..X
XX.J..XXX
XX..J.XXX
XX.X.XXXX
XX...XXXX
XXXXXXXXX
