XXXXXXXXXXX
XX....X..XX
XX.J.J...XX
XXX.XXX..XX
XXX.X.XMXXX
X...XXX...X
X.X.G.G...X
X...XXXXXXX
XXXXXXXXXXX
