XXXXXXX
XXXX..X
X..X..X
X.G.G.X
X.MJJ.X
X.X.XXX
X...XXX
XXXXXXX
