XXXXXXXX
X.X....X
XXX.XX.X
X.GGG..X
X..J.XXX
X.XJXXXX
X..J.XXX
X..M.XXX
XXXXXXXX
