XXXXXXXXXXXX
XX..XX....XX
XX.....XX..X
XX.X.JX..X.X
XX.X..M.JX.X
XX.X..XJ...X
XX.XXX..XXXX
XX.G...XXXXX
X..GXXXXXXXX
X..GXXXXXXXX
XXXXXXXXXXXX
