XXXXXXXXX
X...XXXXX
X..GX..XX
XX.GG..XX
XX.XX.M.X
XX.X....X
XX.J.XXXX
XX.JXXXXX
XX.J.XXXX
XX...XXXX
XXXXXXXXX
