XXXXXXXXXXX
XX.XXXX...X
X.XX.GGGX.X
XXXXJ...X.X
XX..JJXXX.X
XX.M......X
XXXXXXXXXXX
