XXXXXXXXXXXXXX
XXXXXXXXXX...X
XXXXXXXXXX.X.X
XG.....X..J..X
XG..M..X....XX
XGX.XXXXXXX..X
X.........JJ.X
XX..XXXXX....X
XXXXXXXXXXXXXX
