XXXXXXXXXX
XXX..X...X
XXX..J...X
XXX..XXJXX
XXXX.XX..X
X.MGGGXJ.X
X........X
XXXXXX..XX
XXXXXXXXXX
