XXXXXXXX
XX...XXX
XX.X.XXX
X.J...XX
X..JXG.X
XX.J.G.X
XX..XG.X
XXXXX.MX
XXXXX..X
XXXXXXXX
