XXXXXXXX
X......X
X....X.X
XXXGGJGX
XXX.XJXX
XXX..M.X
XXXX.J.X
XXXX.X.X
XXXX...X
XXXXXXXX
