XXXXXXXXXX
XX.....XXX
XX.XXXJ..X
X..GG.J..X
X..GXXJ.XX
XXX.X.MXXX
XXX...XXXX
XXXXXXXXXX
