XXXXXXXXXXX
XXXXX..XXXX
XX.....J.XX
XX..JJ.X.XX
XX.X.MX..XX
XX.XXXX..XX
X..GGG....X
X.XXX.X...X
X.....XXXXX
XXXXXXXXXXX
