XXXXXXXXX
X....XXXX
X.J.M..XX
X..XXX.XX
X.JJ.J.XX
X.....XXX
XXX.XX..X
X.GGGG..X
X.......X
X..XXXXXX
XXXXXXXXX
