XXXXXXXXXXXXX
XXXX.XXXX...X
X..XXX......X
X.GG..JJJJ..X
X.GG..X.MX..X
XXXXXXXXXXXXX
