XXXXXXXXXX
XX.M.XXXXX
X..X..G.XX
X.X......X
X.JJ.XG..X
XX....XXXX
XXX...XXXX
XXXXXXXXXX
