XXXXXXXXXXXX
X..X...XXXXX
X......XXXXX
X..XX.XXXXXX
XX.XX...XXXX
XX.XX.JJJM.X
XX.XX.X....X
X.G.G.G.XXXX
X...XXXXXXXX
XXXXXXXXXXXX
