XXXXXXX
XX...XX
X....XX
X.GJGXX
XXJXJ.X
XXGJG.X
XX....X
XX.M.XX
XXXXXXX
