XXXXXXXXXXX
XXXXXXX.MXX
XXXXXX.J.XX
X..G.X.J..X
X......JX.X
XX.GGX....X
XXX..XXXXXX
XXXXXXXXXXX
