XXXXXXXXXX
XXXXXX...X
XX..+..X.X
X.JJGJJ..X
X..XGX.XXX
XX..G..XXX
XXXXXXXXXX
