XXXXXXXXXXX
XXXXXX...XX
XXXXX..X.XX
XXXXX..M.XX
XXXXX....XX
XXXXXXXGXXX
XXX....G..X
XXX.XJXG..X
X..JJ..XXXX
X.X....XXXX
X...XXXXXXX
XXXXXXXXXXX
