XXXXXXXX
X..JG..X
X..JG..X
XXX..XXX
X..JG..X
XM.JG..X
XXXXXXXX
