XXXXXXXXX
XXXX..XXX
XX.J.J.XX
XX...X.XX
XXXJ...XX
XXX..X.XX
XXXX.X.XX
XXXG.X.XX
XXXGXX.XX
XXXGXX.XX
X.......X
X...M...X
XXXXXXXXX
