XXXXXXXX
XX....XX
XXG.GGXX
XXXJ.M.X
X.J..J.X
X...XXXX
XXXXXXXX
