XXXXXXXX
X....XXX
X.JJ.XXX
XXX.M..X
XXX..G.X
XXXX.GXX
XXXXXXXX
