XXXXXXXXX
XXXXX..XX
XX....J.X
XX.X..X.X
XX.XJJJMX
X.GG..XXX
X.GG.XXXX
XXX..XXXX
XXXXXXXXX
