XXXXXXXXXX
XX....XXXX
XX.J..J.XX
XXXJX.X.XX
XXX.XMX.XX
X.G.G.G..X
X...XX...X
XXXXXXXXXX
