XXXXXXXXXX
X...XXXXXX
X...XXXXXX
XJJJJ.J.MX
XGGGGG...X
XXXXXXXXXX
