XXXXXXXXXXXXXX
XXXXXX...XXXXX
XXXXXX.X.XXXXX
XXXXXX...XXXXX
XXXXXXXJ.XXXXX
X....JGGJXXXXX
X.X.JG..GX...X
X...XG..GJ.X.X
XXXXXJGGJ....X
XXXXX.JXXXXXXX
XXXXX...XXXXXX
XXXXX.X.XXXXXX
XXXXX.M.XXXXXX
XXXXXXXXXXXXXX
