XXXXXXXXXXXX
X...XXXXXXXX
X...J.J.XXXX
XX.J....J.XX
XXXXXXX.GG.X
XXXXXXG.G.MX
XXXXXX.....X
XXXXXXXX..XX
XXXXXXXXXXXX
