XXXXXXX
X.G.G.X
XGJJJGX
X.JMJ.X
XGJJJGX
X.G.G.X
XXXXXXX
