XXXXXXXXX
XXXX..XXX
XXXX.G..X
XXXXJGM.X
XXXX.GJ.X
X..JJGXXX
X.....XXX
XXXXXXXXX
