XXXXXXXXXXXXXXXXX
XX.....XXXXXX...X
XX......M.GGG...X
X..XXXXXXXXXX.XXX
X.J..J...J.....XX
X..X...X...X...XX
XXXXXXXXXXXXXXXXX
