XXXXXXXX
X..X...X
X..XGG.X
X.JJJJJX
X..XGGGX
X..X...X
X..M...X
XXXXXXXX
