XXXXXXXXX
XX.....XX
X..JGJ..X
X.JXGXJ.X
XXGGMGG.X
X.JXGXJ.X
X..JGJ..X
X...X..XX
XXXXXXXXX
