XXXXXXX
XXX...X
X..JX.X
X..GJ.X
XX.XXGX
XX...MX
XXXXXXX
