XXXXXXXX
X...X..X
X.JGJG.X
XXG..J.X
X.J..GXX
X.GJGJ.X
X..X..MX
XXXXXXXX
