XXXXXXXXX
X.......X
X.JGJGJ.X
X.GJGJG.X
XXJGMGJXX
X.GJGJG.X
X.JGJGJ.X
X.......X
XXXXXXXXX
