XXXXXXXXX
XXXXX..XX
XX.....XX
XXGX.X.XX
XMJ.JX..X
X.GJ....X
XXGJXX..X
XXG.XXXXX
XXXXXXXXX
