XXXXXXXXX
X...X...X
X.GJGJG.X
X.JGJGJ.X
XXGJMJGXX
X.JGJGJ.X
X.GJGJG.X
X...X...X
XXXXXXXXX
