XXXXXXXXX
X.......X
X.GJGJG.X
X.JGJGJ.X
X.GJMJG.X
X.JGJGJ.X
X.GJGJG.X
X.......X
XXXXXXXXX
