XXXXXXXXXXXX
X.G..XXX..XX
X......M..XX
XGGGGX.JX..X
XXXXXX.J...X
XXXXXXXJ.J.X
XXXXXXX...XX
XXXXXXX.JXXX
XXXXXXX..XXX
XXXXXXXXXXXX
