XXXXXXXXXXXX
XXXXXX..XXXX
XXXXXX.G..XX
XXXXXG.G...X
XXXXXG..XM.X
XXXXXX.XX..X
XXXXX..XXXXX
XXXX.J.XXXXX
XXX.J..XXXXX
XX.J..XXXXXX
X.J..XXXXXXX
X...XXXXXXXX
XXXXXXXXXXXX
