XXXXXXXXXXXXX
XXXXXXXXX..XX
XXXXXXXXX..XX
XXXXXXX....XX
XXXXXX..XJXXX
XXXXXX.J.J..X
XXXXXXXJ....X
XXXXXXX..XXXX
X.....X..XXXX
X..M..XX..XXX
X..X..GGGGXXX
X....XXXXXXXX
XXXXXXXXXXXXX
