XXXXXXXX
X..XX..X
X..GG..X
X.G..G.X
XXX.XXXX
XX....XX
XX.JJM.X
XXXX.J.X
XXX..X.X
X....J.X
X....XXX
XXXXXXXX
