XXXXXXXXXX
XXX...XXXX
XX..X.XXXX
XX....XXXX
X..J.XXXXX
X..JJXG.XX
XXXJ....XX
XXX..X..XX
XXXXXXG.XX
XXXXMXG.XX
XXXX..G..X
XXXX.....X
XXXXXXXXXX
