XXXXXXXXXXXX
XX..X..XXXXX
XX..X..G.XXX
XX...J.X.M.X
XXX.X.J.J..X
XXX.XXGGXXXX
XXX..X..XXXX
XXX.XXX.XXXX
X.....J...XX
X...XXXG..XX
XXXXXXXXXXXX
